А - Анкилозавр
Б - Брахиозавр
В - Велоцераптор
Г - Гастония
Д - Диметродон
Е - Египтозавр
Ё - 
Ж - Жираффатитан
З - Зауролоф
И - Ихтеозавр, Индоминус, Игуанадон
Й - 
К - Карнотавр
Л - Лесотозавр, Ликорин
М - Майазавр, Мозазавр
Н - Нотроних, Насутоцератопс
О - Орнитомим
П - Паразауролов
Р - Рамфоринх
С - Стигимолох, Спинозоавр, Стегозавр
Т - Трицератопс, Тиранозавр
У - Уранозавр
Ф - Фалкарий
Х - Хасмозавр
Ц - Целофизис
Ч - Чуаньдуноцелур
Ш - Шамозавр
Щ -
Ъ - 
Ы - 
Ь - 
Э - Эвоплоцефал
Ю - Ютараптор
Я - Ямацератопс
